111111111
1ABCDEFG1
1ABCDEFG1
1ABCDEFG1
111111111
