111111111
1001E1001
10C100001
100100P01
111111111
