1111111111
100C1000C1
1000001101
1C1111P1E1
1000000101
1111111111